NO       ./textures/walls/NORTH.xpm


SO ./textures/walls/SOUTH.xpm

WE       ./textures/walls/WEST.xpm




EA         ./textures/walls/EAST.xpm

F                   220,105,180
C 128,128,128

111111111111111111111111
100000000000000000000001
100000000000000000000001
100000000000000000000001
100000111110000101010001
100000100010000000000001
100000100010000100010001
100000100010000000000001
100000110110000001010001
100000000000000000000001
100000000000000000000001
10000000000000000000111
1E00000000000000000001
110000000000001111000111
  1110000000000000000001
111100000000000000000001
111111111000000000000001
110100001000000000000001
110000010100000000000001
110100001000000000000001
110111111000000000000001
110000000000000000000001
111111111000000000000001
111111111111111111111111