NO ./textures/walls/NORTH.xpm
SO ./textures/walls/SOUTH.xpm
WE ./textures/walls/WEST.xpm
EA ./textures/walls/EAST.xpm

F 0,139,139
C 255,20,147

111111111111111111111111
100000000000000000000001
100000000000000000000001
100000000000000000000001
100000111110000101010001
100000100010000000000001
100000100010000100010001
100000100010000000000001
10000011D110000101010001
100000000000000000000001
100000000000000000000001
100000000000000000000001
120W00000000000000000001
110000000000001111000001
  1110000000000000000001
111100000000000000000001
111111111000000000000001
110100001000000000000001
110000010100000000000001
110100001000000000000001
110111111000000000000001
110000000000000000000001
111111111000000000000001
111111111111111111111111
