NO ./walls/xpm/north_wall.xpm
SO ./walls/xpm/south_wall.xpm
WE ./walls/xpm/west_wall.xpm
EA ./walls/xpm/east_wall.xpm

F 220,100,0
C 225,30,0

111111111111111111111111
100000000000000000000001
100000000000000000000001
100000000000000000000001
100000111110000101010001
100000100010000000000001
100000100010000100010001
100000100010000000000001
100000110110000101010001
100000000000000000000001
100000000000000000000001
100000000000000000000001
100W00000000000000000001
110000000000001111000001
  1110000000000000000001
111100000000000000000001
111111111000000000000001
110100001000000000000001
110000010100000000000001
110100001000000000000001
110111111000000000000001
110000000000000000000001
111111111000000000000001
111111111111111111111111