NO ./textures/walls/NORTH.xpm
SO ./textures/walls/SOUTH.xpm
WE ./textures/walls/WEST.xpm
EA ./textures/walls/EAST.xpm
F 220,100,0
C 225,30,0

1111111111111111111111111
1                       1
1              1        1
1              1        1
1              1        1
1              1        1
1              1        1
1              1        1
1111111111111111111111111
