NO ./textures/walls/NORTH.xpm
SO ./textures/walls/SOUTH.xpm
WE ./textures/walls/WEST.xpm
EA ./textures/walls/EAST.xpm

F 220,100,0
C 225,30,0

   111 1111
   10111  1
   1N001  1
   10001  1
   11111111
