NO ./textures/walls/NORTH.xpm
SO ./textures/walls/SOUTH.xpm
WE ./textures/walls/WEST.xpm
EA ./textures/walls/EAST.xpm

F 220,100,0
C 225,30,0

    111111111111111111111111111
1111101000000000000001000000001111
1000001000000000000001000000000001
1000001111111111111111111111110001
1000000000000010000000000000010001
1111100000000010000N00000000010001
    100000000010000000000000011111
    10000000001000000111111111   1
    111111111111111111       11111

