NO ./textures/walls/NORTH.xpm
SO ./textures/walls/SOUTH.xpm
WE ./textures/walls/WEST.xpm
EA ./textures/walls/EAST.xpm

F 220,100,0
C 225,30,0

     11111111111111111111111
     1E000000000000000000001
     11111000000010000111111
11111100010010000110111
10000000000010000100001
1000000000001000010011111111111111
10000000010010000000000001       1
10000000010010000100000001       1
1111111111110111110010000111111111
   1000100000100010010000000000001
   1000100000100000010000000000001
   1000000000100000010000000000001
   1111111111111111110010000000001
             100000000010000000001
             100000000000000000001
             111111111111111111111
